2 15 25
#########################
#p    ***# *  s * * *   #
# # #*# # #*#*# # #*#*# #
#*  *    ***    * 2 * * #
# # # # # #*# # # # # #*#
#f     x **  *#   2     #
# # #2# # # #*# #*# # # #
#*  *   #* **    *      #
# #*# #*# # # #*#*# # # #
#*    **  * #   *       #
# #*# # # # # # #*#*# # #
#  1*    *  f*  *       #
#*# # # # #*#*# # # # # #
#*  * #   *  *   *      #
#########################
