1 15 25
#########################
#p     **# *    * * *   #
# # #*# # #*#*# # #*#*# #
#s  *    ***1   * 2 * * #
# # # # # #*# # # # # #*#
#f     x **  *#   1*    #
# # #3# # # #*# #*# # # #
#*  *   #* 1*    *      #
# #*# #*# # # #*#*# # # #
#*4   **  * #   *       #
# #*# # # # # # #*#*# # #
#  1*    *   *  *       #
#*# # # # #*#*# # # # # #
#*  * #   *  *   *      #
#########################
