3 15 25
#########################
#p     x*# *    * * *   #
# # #*# # #*#*# # #*#*# #
#*  *    ***    * 1 * * #
# # # # # #*# # # # # #*#
#3     f **  *#   3     #
# # #2# # # #*# #*# # # #
#*  *   #* **   s*      #
# #*# #*# # # #*#*# # # #
#*    **  * #   *       #
# #*# # # # # # #*#*# # #
#   2    *  f*  *   1   #
#*# # # # #*#*# # # # # #
#*  * #   *  *   *      #
#########################
