1 15 25
#########################
#p    ***# *  1 * * *   #
# # #*# # #*#*# # #*#*# #
#s  *    ***    * 2 * * #
# # # # # #*# # # # # #*#
#f     x **  *#   1     #
# # #2# # # #*# #*# # # #
#*  *   #* 1*    *      #
# #*# #*# # # #*#*# # # #
#*    **  * #   *       #
# #*# # # # # # #*#*# # #
#  1*    *   *  *       #
#*# # # # #*#*# # # # # #
#*  * #   *  *   *      #
#########################
