1 15 25
#########################
#p    ***# *  1 * * *   #
# # #*# # #*#*# # #*#*# #
#  x*    ***    * 2 * * #
# # # # # #*# # # # # #*#
#f     x **  *#   1     #
# # # # # # #*# #*# # # #
#*  *   #*  *    *      #
# #*# #*# # # #*#*# # # #
#*    **  * #   *       #
# #*# # # # # # #*#*# # #
#   *    *   *  *       #
#*# # # # #*#*# # # # # #
#*  * #   *  *   *      #
#########################
