5 15 25
#########################
#p     **# *2   * * *   #
# # #*# # #*#*# # #*#*# #
#   *    w**    *   * * #
# # # # # #*# # # # # #*#
#*       f*  *#   2*n   #
# # #*# # # #*# #*# # # #
#* w*   #* 5*    *   4  #
# #*# #*# # # #*#*# # # #
#*   3 **  * #   *      #
# #*# # # # # # #*#*# # #
#   *5   x  1*  *    s  #
#*# # # # #*#*# # # # # #
#*  * #   *  *   *      #
#########################
