3 15 25
#########################
#p     1*# *    * * *   #
# # #*# # #*#*# # #*#*# #
#*  *    ***    * 1 * * #
# # # # # #*# # # # # #*#
#n     f **  *#   3     #
# # #5# # # #*# #*# # # #
#*  *   #x **   s*  4   #
# #*# #*# # # #*#*# # # #
#*    **  * #   *       #
# #*# # # # # # #*#*# # #
#   2    *  f*  *   1   #
#*# # # # #*#*# # # # # #
#*  * #   *  *   *      #
#########################
