1 15 25
#########################
#p     **# *    * * *   #
# # #*# # #*#*# # #*#*# #
#n  *    ***1   *   * * #
# # # # # #*# # # # # #*#
#f     x **  *#   1*    #
# # #*# # # #*# #*# # # #
#*  *   #* 5*    *   1  #
# #*# #*# # # #*#*# # # #
#*   1 **  * #   *      #
# #*# # # # # # #*#*# # #
#   *    *  2*  *       #
#*# # # # #*#*# # # # # #
#*  * #   *  *   *      #
#########################
