2 15 25
#########################
#p    *s*# *    *   *   #
# # #*# # #*#*# # #*#*# #
#*  *    ***    * 2 * * #
# # # # # #*# # # # # #*#
#f      1**  *#   2     #
# # # # # # #*# #*# # # #
#*  *   #* **    *   x  #
# #*# #*# # # #*#*# # # #
#*3   **  * #   *       #
# #*# # # # # # #*#*# # #
#   *1   *  n*  *    1  #
#*# # # # #*#*# # # # # #
#*  * #   *  *   *      #
#########################
