4 15 25
#########################
#p     **# *4   * * *   #
# # #*# # #*#*# # #*#*# #
#   *    s**    *   * * #
# # # # # #*# # # # # #*#
#f       **  *#   1*n   #
# # #*# # # #*# #*# # # #
#*  *   #* 5*    *   1  #
# #*# #*# # # #*#*# # # #
#*   3 **  * #   *      #
# #*# # # # # # #*#*# # #
#   *w   x  2*  *       #
#*# # # # #*#*# # # # # #
#*  * #   *  *   *      #
#########################
